
   Follow links for ISO-3166-2 subdivision codes

   AF : Afganistán
   AL : Albania
   AQ : Antártida
   DZ : Argelia
   AS : Samoa Americana
   AD : Andorra
   AO : Angola
   AG : Antigua y Barbuda
   AZ : Azerbaiyán
   AR : Argentina
   AU : Australia
   AT : Austria
   BS : Bahamas
   BH : Bahréin
   BD : Bangladesh
   AM : Armenia
   BB : Barbados
   BE : Bélgica
   BM : Bermudas
   BT : Bután
   BO : Bolivia
   BA : Bosnia y Herzegovina
   BW : Botsuana
   BV : Isla Bouvet
   BR : Brasil
   BZ : Belice
   IO : Territorio Británico del Océano Índico
   SB : Islas Salomón
   VG : Islas Vírgenes Británicas
   BN : Brunéi
   BG : Bulgaria
   BU : Myanmar
   MM : Myanmar
   BI : Burundi
   BY : Bielorrusia
   KH : Camboya
   CM : Camerún
   CA : Canadá
   CV : Cabo Verde
   KY : Islas Caimán
   CF : República Centroafricana
   LK : Sri Lanka
   TD : Chad
   CL : Chile
   CN : China
   TW : Taiwán
   CX : Isla de Navidad
   CC : Islas Cocos
   CO : Colombia
   KM : Comoras
   YT : Mayotte
   CG : República del Congo
   CD : República Democrática del Congo
   ZR : República Democrática del Congo
   CK : Islas Cook
   CR : Costa Rica
   HR : Croacia
   CU : Cuba
   CY : Chipre
   CZ : República Checa
   BJ : Benín
   DK : Dinamarca
   DM : Dominica
   DO : República Dominicana
   EC : Ecuador
   SV : El Salvador
   GQ : Guinea Ecuatorial
   ET : Etiopía
   ER : Eritrea
   EE : Estonia
   FO : Islas Feroe
   FK : Islas Malvinas
   GS : Islas Georgias del Sur y Sandwich del Sur
   FJ : Fiyi
   FI : Finlandia
   AX : Åland
   FR : Francia
   GF : Guayana Francesa
   PF : Polinesia Francesa
   TF : Territorios Australes Franceses
   DJ : Yibuti
   GA : Gabón
   GE : Georgia
   GM : Gambia
   PS : Palestina (ANP)
   DE : Alemania
   GH : Ghana
   GI : Gibraltar
   KI : Kiribati
   GR : Grecia
   GL : Groenlandia
   GD : Granada
   GP : Guadalupe
   GU : Guam
   GT : Guatemala
   GN : Guinea
   GY : Guyana
   HT : Haití
   HM : Islas Heard y McDonald
   VA : Ciudad del Vaticano
   HN : Honduras
   HK : Hong Kong
   HU : Hungría
   IS : Islandia
   IN : India
   ID : Indonesia
   IR : Irán
   IQ : Iraq
   IE : Irlanda
   IL : Israel
   IT : Italia
   CI : Costa de Marfil
   JM : Jamaica
   JP : Japón
   KZ : Kazajistán
   JO : Jordania
   KE : Kenia
   KP : Corea del Norte
   KR : Corea del Sur
   KW : Kuwait
   KG : Kirguistán
   LA : Laos
   LB : Líbano
   LS : Lesoto
   LV : Letonia
   LR : Liberia
   LY : Libia
   LI : Liechtenstein
   LT : Lituania
   LU : Luxemburgo
   MO : Macao
   MG : Madagascar
   MW : Malawi
   MY : Malasia
   MV : Maldivas
   ML : Malí
   MT : Malta
   MQ : Martinica
   MR : Mauritania
   MU : Mauricio
   MX : México
   MC : Mónaco
   MN : Mongolia
   MD : Moldavia
   ME : Montenegro
   MS : Montserrat
   MA : Marruecos
   MZ : Mozambique
   OM : Omán
   NA : Namibia
   NR : Nauru
   NP : Nepal
   NL : Países Bajos
   AN : Antillas Neerlandesas
   AW : Aruba
   NC : Nueva Caledonia
   VU : Vanuatu
   NZ : Nueva Zelanda
   NI : Nicaragua
   NE : Níger
   NG : Nigeria
   NU : Niue
   NF : Norfolk
   NO : Noruega
   MP : Islas Marianas del Norte
   UM : Islas ultramarinas de Estados Unidos
   FM : Micronesia
   MH : Islas Marshall
   PW : Palaos
   PK : Pakistán
   PA : Panamá
   PG : Papúa Nueva Guinea
   PY : Paraguay
   PE : Perú
   PH : Filipinas
   PN : Islas Pitcairn
   PL : Polonia
   PT : Portugal
   GW : Guinea-Bissau
   TL : Timor Oriental
   PR : Puerto Rico
   QA : Qatar
   RE : Reunión
   RO : Rumania
   RW : Ruanda
   SH : Santa Helena
   KN : San Cristóbal y Nieves
   AI : Anguila
   LC : Santa Lucía
   PM : San Pedro y Miquelón
   VC : San Vicente y las Granadinas
   SM : San Marino
   ST : Santo Tomé y Príncipe
   SA : Arabia Saudita
   SN : Senegal
   RS : Serbia
   SC : Seychelles
   SL : Sierra Leona
   SG : Singapur
   SK : Eslovaquia
   VN : Vietnam
   SI : Eslovenia
   SO : Somalia
   ZA : Sudáfrica
   ZW : Zimbabue
   ES : España(Ceuta y Melilla)
   EH : Sahara Occidental
   SD : Sudán
   SR : Surinam
   SJ : Svalbard y Jan Mayen
   SZ : Suazilandia
   SE : Suecia
   CH : Suiza
   SY : Siria
   TJ : Tayikistán
   TH : Tailandia
   TG : Togo
   TK : Tokelau
   TO : Tonga
   TT : Trinidad y Tobago
   AE : Emiratos Árabes Unidos
   TN : Túnez
   TR : Turquía
   TM : Turkmenistán
   TC : Islas Turcas y Caicos
   TV : Tuvalu
   UG : Uganda
   UA : Ucrania
   MK : ARY Macedonia
   EG : Egipto
   GB : Reino Unido
   GG : Guernsey
   JE : Jersey
   IM : Isla de Man
   TZ : Tanzania
   US : Estados Unidos
   VI : Islas Vírgenes Estadounidenses
   BF : Burkina Faso
   UY : Uruguay
   UZ : Uzbekistán
   VE : Venezuela
   WF : Wallis y Futuna
   WS : Samoa
   YE : Yemen
   ZM : Zambia
