
ISO3166-2 regions for NG

   NG-FC : Abuja Capital Tercltory
   NG-AB : Abia
   NG-AD : Adamawa
   NG-AK : Akwa Ibom
   NG-AN : Anambra
   NG-BA : Bauchi
   NG-BE : Benue
   NG-BO : Borno
   NG-CR : Cross River
   NG-DE : Delta
   NG-ED : Edo
   NG-EN : Enugu
   NG-IM : Imc
   NG-JI : Jigawa
   NG-KD : Kaduna
   NG-KN : Kano
   NG-KT : Rataina
   NG-KE : Kebbi
   NG-KO : Kogi
   NG-KW : Kwara
   NG-LA : Lagos
   NG-NI : Niger
   NG-OG : Ogun
   NG-ON : Ondo
   NG-OS : Osun
   NG-OY : Oyo
   NG-PL : Plateau
   NG-RI : Rivers
   NG-SO : Sokoto
   NG-TA : Taraba
   NG-YO : Yobe
