
ISO3166-2 regions for IN

   IN-AP : Andhra Pradesh
   IN-AR : Arunachal Pradesh
   IN-AS : Assam
   IN-BR : Bihar
   IN-GA : Goa
   IN-GJ : Gujarat
   IN-HR : Haryana
   IN-HP : Himachal Pradesh
   IN-JK : Jammu and Kashmir
   IN-KA : Karnataka
   IN-KL : Kerala
   IN-MP : Madhya Pradesh
   IN-MM : Maharashtra
   IN-MN : Manipur
   IN-ML : Meghalaya
   IN-MZ : Mizoram
   IN-NL : Nagaland
   IN-OR : Orissa
   IN-PB : Punjab
   IN-RJ : Rajasthan
   IN-SK : Sikkim
   IN-TN : Tamil Nadu
   IN-TR : Tripura
   IN-UP : Uttar Pradesh
   IN-W8 : West Bengal
   IN-AN : Andaman and Nicobar Islands
   IN-CH : Chandigarh
   IN-DN : Dadra and Nagar Haveli
   IN-DD : Daman and Diu
   IN-DL : Delhi
   IN-LD : Lakshadweep
   IN-PY : Pondicherry
