
ISO3166-2 regions for AZ

   AZ-MM : Naxçivan
   AZ-AB : Äli Bayramli
   AZ-BA : Bäki
   AZ-GA : Gäncä
   AZ-LA : Länkäran
   AZ-MI : Mingäçevir
   AZ-NA : Naftalan
   AZ-SA : Säki
   AZ-SM : Sumqayit
   AZ-SS : Susa
   AZ-XA : Xankandi
   AZ-YE : Yevlax
   AZ-ABS : Abseron
   AZ-AGC : Agcabädi
   AZ-AGM : Agdam
   AZ-AGS : Agdas
   AZ-AGA : Agstafa
   AZ-AGU : Agsu
   AZ-AST : Astara
   AZ-BAB : Babäk
   AZ-BAL : Balakän
   AZ-BAR : Bärdä
   AZ-BEY : Beylägan
   AZ-BIL : Biläsuvar
   AZ-CAB : Cäbrayll
   AZ-CAL : Cälilabad
   AZ-CUL : Culfa
   AZ-DAS : Daskäsän
   AZ-DAV : Däväçi
   AZ-FUZ : Fuzuli
   AZ-GAD : Gädäbäy
   AZ-GOR : Goranboy
   AZ-GOY : Göyçay
   AZ-HAC : Haciqabul
   AZ-IMI : Imisli
   AZ-ISM : Ismayilli
   AZ-KAL : Kälbäcär
   AZ-KUR : Kurdämir
   AZ-LAC : Laçin
   AZ-LAN : Länkäran
   AZ-LER : Lerik
   AZ-MAS : Masalli
   AZ-NEF : Neftcala
   AZ-OGU : Oguz
   AZ-ORD : Ordubad
   AZ-QAB : Qäbälä
   AZ-QAX : Qax
   AZ-QAZ : Qazax
   AZ-QOB : Qobustan
   AZ-QBA : Quba
   AZ-QBI : Qubadli
   AZ-QUS : Qusar
   AZ-SAT : Saatli
   AZ-SAB : Sabirabad
   AZ-SAD : Sadarak
   AZ-SAH : Sahbuz
   AZ-SAK : Säki
   AZ-SAL : Salyan
   AZ-SMI : Samaxi
   AZ-SKR : Sämkir
   AZ-SMX : Samux
   AZ-SAR : Särur
   AZ-SIY : Siyäzän
   AZ-SUS : Susa
   AZ-TAR : Tartar
   AZ-TOV : Tovuz
   AZ-UCA : Ucar
   AZ-XAC : Xacmaz
   AZ-XAN : Xanlar
   AZ-XIZ : Xizi
   AZ-XCI : Xocali
   AZ-XVD : Xocavand
   AZ-YAR : Yardimli
   AZ-YEV : Yevlax
   AZ-ZAN : Zängilan
   AZ-ZAQ : Zaqatala
   AZ-ZAR : Zärdab
