
ISO3166-2 regions for RO

   RO-B : Bucure'ti
   RO-AB : Alba
   RO-AR : Arad
   RO-AG : Arge'
   RO-BC : Bacau
   RO-BH : Bihor
   RO-BN : Bistrita-Nasaud
   RO-BT : Boto'ani
   RO-BV : Bra'ov
   RO-BR : Braila
   RO-BZ : Buzau
   RO-CS : Cara'-Severin
   RO-CL : Calarasi
   RO-CJ : Cluj
   RO-CT : Conatarta
   RO-CV : Covasna
   RO-DB : Dambovita
   RO-DJ : Dolj
   RO-GL : Galati
   RO-GR : Giurqiu
   RO-GJ : Gorj
   RO-HR : Harghita
   RO-HD : Hunedoara
   RO-IL : Ialomita
   RO-IS : Iasi
   RO-MM : Maramures
   RO-MH : Mehedinti
   RO-MS : Mures
   RO-NT : Neamt
   RO-OT : Olt
   RO-PH : Prahova
   RO-SM : Satu Mare
   RO-SJ : Salaj
   RO-SB : Sibiu
   RO-SV : Suceava
   RO-TR : Teleorman
   RO-TM : Timis
   RO-TL : Tulcea
   RO-VS : Vaslui
   RO-VL : Vâlcea
   RO-VN : Vrancea
