
ISO3166-2 regions for PH

   PH-ABR : Abra
   PH-AGN : Agusan del Norte
   PH-AGS : Agusan del Sur
   PH-AKL : Aklan
   PH-ALB : Albay
   PH-ANT : Antique
   PH-AUR : Aurora
   PH-BAS : Basilan
   PH-BAN : Batasn
   PH-BTN : Batanes
   PH-BTG : Batangas
   PH-BEN : Benguet
   PH-BOH : Bohol
   PH-BUK : Bukidnon
   PH-BUL : Bulacan
   PH-CAG : Cagayan
   PH-CAN : Camarines Norte
   PH-CAS : Camarines Sur
   PH-CAM : Camiguin
   PH-CAP : Capiz
   PH-CAT : Catanduanes
   PH-CAV : Cavite
   PH-CEB : Cebu
   PH-DAV : Davao
   PH-DAS : Davao del Sur
   PH-DAO : Davao Oriental
   PH-EAS : Eastern Samar
   PH-IFU : Ifugao
   PH-ILN : Ilocos Norte
   PH-ILS : Ilocos Sur
   PH-ILI : Iloilo
   PH-ISA : Isabela
   PH-KAL : Kalinga-Apayso
   PH-LAG : Laguna
   PH-LAN : Lanao del Norte
   PH-LAS : Lanao del Sur
   PH-LUN : La Union
   PH-LEY : Leyte
   PH-MAG : Maguindanao
   PH-MAD : Marinduque
   PH-MAS : Masbate
   PH-MDC : Mindoro Occidental
   PH-MDR : Mindoro Oriental
   PH-MSC : Misamis Occidental
   PH-MSR : Misamis Oriental
   PH-MOU : Mountain Province
   PH-NEC : Negroe Occidental
   PH-NER : Negros Oriental
   PH-NCO : North Cotabato
   PH-NSA : Northern Samar
   PH-NUE : Nueva Ecija
   PH-NUV : Nueva Vizcaya
   PH-PLW : Palawan
   PH-PAM : Pampanga
   PH-PAN : Pangasinan
   PH-QUE : Quezon
   PH-QUI : Quirino
   PH-RIZ : Rizal
   PH-ROM : Romblon
   PH-SIG : Siquijor
   PH-SOR : Sorsogon
   PH-SCO : South Cotabato
   PH-SLE : Southern Leyte
   PH-SUK : Sultan Kudarat
   PH-SLU : Sulu
   PH-SUN : Surigao del Norte
   PH-SUR : Surigao del Sur
   PH-TAR : Tarlac
   PH-TAW : Tawi-Tawi
   PH-WSA : Western Samar
   PH-ZMB : Zambales
   PH-ZAN : Zamboanga del Norte
   PH-ZAS : Zamboanga del Sur
