
ISO3166-2 regions for UG

   UG-APA : Apac
   UG-ARU : Arua
   UG-BUN : Bundibugyo
   UG-BUS : Bushenyi
   UG-GUL : Gulu
   UG-HOI : Hoima
   UG-IGA : Iganga
   UG-JIN : Jinja
   UG-KBL : Kabale
   UG-KBR : Kabarole
   UG-KLG : Kalangala
   UG-KLA : Kampala
   UG-KLI : Kamuli
   UG-KAP : Kapchorwa
   UG-KAS : Kasese
   UG-KLE : Kibeale
   UG-KIB : Kiboga
   UG-KIS : Kisoro
   UG-KIT : Kitgum
   UG-KOT : Kotido
   UG-KUM : Kumi
   UG-LIR : Lira
   UG-LUW : Luwero
   UG-MSK : Masaka
   UG-MSI : Masindi
   UG-MBL : Mbale
   UG-MBR : Mbarara
   UG-MOR : Moroto
   UG-MOY : Moyo
   UG-MPI : Mpigi
   UG-MUB : Mubende
   UG-MUK : Mukono
   UG-NEB : Nebbi
   UG-NTU : Ntungamo
   UG-PAL : Pallisa
   UG-RAK : Rakai
   UG-RUK : Rukungiri
   UG-SOR : Soroti
   UG-TOR : Tororo
